A #   # #   #  
  # # # ### ## 
#   #     #    
 ##  #### #### 
    #   #   #  
### ### ### # #
  #       #   #
 # ###### ###  
       #    #  
###### #### ## 
          #    
 ######## #### 
       #       
###### ####### 
             B