#######
#A #  #
#  ## #
#     #
## ##B#
#######