A #   #   # #   #   
  # # ### # # ### # 
#   #     #     # # 
 ##  #### ##### ### 
    #   #   #       
### ### ### ### ### 
  #       #     #   
 # ###### ### ### # 
       #          # 
###### #### ##### # 
          #       # 
 ######## ####### # 
       #            
###### ############ 
                    
 #### ### ####### # 
       #       #  # 
###### #### ##### # 
                   B
####################